1111111111
1000000001
100P000001
1000011111
1000000001
111110C001
100C000101
1000001101
100C001E01
1111111111