1111111111
1000000001
10P0000001
1000011111
1000000001
1111100001
1000000101
1000001101
100C001001
1111111111